workshop - мастерская
surpassed - превзойдённый
greenhouse - парник
consider - считать
consider - рассматривать
nearly - почти
per capita - на душу населения
responsibility - ответственность
emission - выделение теплоты
blame - вина
household - хозяйство
consumption - потребление
drastic - сущейственный
drastic - радикальный
directly - прямая (ответственность)
carbon - углерод
heat - нагревать
burn - сжигать
dishwasher - посудомоечная машина
deeper - более глубокий
beef - говядина
require - требовать
grain - зерно
grow - расти
relatively - относительно
dairy - средний
dairy - молочная
similarly - аналогично
processed - обработанный
ship - отправка
mostly - в основном
follow - следовать
predictable - предсказуемый
pattern - схема
inhabitant - житель
worst - наихудший
performer - игроком (зд.)
express - выражение (зд.)
sulphur - сера
closely - внимательно
comparison - сравнение
rely - полагаться
prevalence - распространённость
income - доход
fossil fuels - ископаемое топливо
significant - значительный
measured - измеренный
measured - измеряемый
land use - землепользование
gross - валовой
advantage - преимущество
measure - мера
pinpoint - указывать
actionable - действенный
accurate - точный
lack - отсутствие
performance - показатель (зд.)
eventually - в конце концов
effort - усилие (зд.)
designed - предназначенный
meantime - тем временем
purchase - покупка
switche - отключится (зд.)
less - меньше
